1111111111111111111111111111
1P00000000000000000X00000101
1011111111101111111111010101
1000000000100000000000010101
1011101110110111011101010101
1010101010101010101000010101
1010101010101010101111010101
1000000010000010000000010101
1111101111010110111111010101
10000000000100X0000000010101
1011111111110111111111010101
1000000000C00000000000010101
101011111011111111011101C101
1010100000100000010000010101
1010111011111011110111010101
100000101000000000E100010101
1111101010111111010101010101
1000001010000000010000010101
1010111011111011110111010101
1010100000100000000000010101
1011111111110111111111010101
1000000000010000000000010101
1011101110110111011101010101
1000000000100000000000010101
1011111111101111111111010101
100000000000000000000000C011
1111111111111111111111111111