11111111111111111111111111111111
1X00000X0000000001C10000011E0001
10000100100100000101011101111101
1000X10010010000000100010111P001
10000100100100000001110100000111
100C0001001001000000000111111111
10000000011000000001110000001111
111100C001100C000001111111101111
1C00000001100C00000110C00C001111
11111111111111111111111111111111