11111111111111111111111111111111111111111
1P000000000000000000000000000000100010C01
10101011111110110101111011110100000101001
10001000100010100010100000101000100000001
11101110101010100010101111101101111111101
100000101010100C1010000010000010000000001
10111110101011111010111011111111011110101
101000001000100C00100000100000100C0010001
10101110111110111101111000000111111111001
101000100010100010100C001010C010000000101
10111110110101010101111101101011111111101
10000C10000010100010000000100010001000001
11111110111011111111111011111010111010001
1000000010100000C010001000100010001000101
10111111101010111010101011101111111011101
1010000000101000C01010100000100000001C001
10111111111110111010101011110111011111001
101000100000001000001010100000000C0000111
10101011111101111011101010111101111111101
101010000000000010000010101000000C1000101
10101111111110110101110100011011111111111
101000000000001010000010100001000100010C1
1011111011111010111111111C110101010101001
10001000100010100C00000010000001010101001
11111110101110111111111011111101010101001
1000C0001000001000000000000000010001000E1
11111111111111111111111111111111111111111