11111111111111111111111111111111
100000000000000001010000011E0001
10000100100100000101011101111101
10000100100100000001000101110001
10000100100100000001110100000111
100000010010010P0000000111111111
10000000011000000001110000C01111
111100000110000C0001111111101111
10000000011000000001100000001111
11111111111111111111111111111111